10 10
132 132 132 132 132 132 132 132 132 132
132 114 132 132 55 132 132 132 132 132
132 132 132 132 132 83 67 77 132 132
132 132 132 132 132 132 132 132 132 132
132 4 132 132 132 132 132 132 132 132
132 132 132 114 132 132 132 132 132 25
132 132 132 132 132 132 132 132 132 67
132 132 148 38 67 77 132 132 132 86
44 132 132 132 132 132 132 4 67 132
161 132 132 132 132 132 132 132 132 51
