8 8
132 132 4 67 77 132 132 132
132 132 132 132 132 132 132 132
132 132 132 132 25 132 132 132
132 132 135 51 67 79 132 132
132 132 132 132 86 132 132 132
132 132 132 132 132 132 132 132
132 132 132 132 132 132 132 132
132 132 161 132 132 132 132 132
