8 8
132 132 132 132 40 40 40 161
67 132 132 132 40 40 40 132
25 132 132 132 132 132 132 132
132 132 132 132 132 132 132 25
132 132 132 132 132 132 132 67
132 132 132 132 132 132 132 86
132 132 51 114 132 132 132 132
132 132 132 132 132 4 67 77
