8 8
132 132 132 132 132 4 67 86
132 132 64 67 78 114 132 132
132 132 132 4 67 132 132 132
132 132 4 67 132 132 132 132
132 132 67 77 132 132 132 132
132 132 132 132 132 132 132 132
132 132 132 132 132 132 132 132
132 132 132 132 132 132 132 132
