15 18
132 132 132 132 132 132 132 132 132 132 132 150 132 132 132
132 132 132 132 132 132 132 132 132 132 132 150 132 132 132
132 132 132 132 132 132 132 132 132 132 132 150 132 132 132
132 114 132 132 132 132 132 132 132 132 132 150 132 132 132
132 132 132 132 132 132 132 132 132 132 132 150 132 132 132
132 132 132 132 132 132 132 132 132 132 132 150 132 132 132
132 132 132 132 132 132 132 132 132 132 132 150 132 132 132
132 132 132 132 132 132 132 4 67 77 132 150 132 132 135
132 132 132 132 132 132 132 132 132 132 132 150 132 132 132
38 132 132 132 132 132 132 132 132 132 132 150 132 132 132
4 67 77 132 132 132 132 132 148 132 132 150 132 132 132
132 132 132 132 132 132 132 132 132 132 132 150 132 132 132
132 132 132 132 132 132 132 132 132 132 132 150 132 132 132
132 132 132 132 132 132 132 132 67 88 132 150 132 132 132
132 132 132 132 132 132 132 132 132 132 132 150 132 132 132
132 132 132 132 132 132 132 132 132 132 132 150 25 67 86
132 132 132 132 132 132 132 132 132 132 132 150 132 132 132
132 132 132 132 132 132 132 132 132 132 132 150 40 67 132
