13 14
132 132 132 132 132 132 132 132 132 132 132 132 132
132 132 132 132 132 132 161 132 132 51 67 79 132
132 132 132 132 132 132 161 132 132 132 132 132 132
132 132 132 132 132 132 161 132 132 132 132 86 132
132 132 161 161 161 132 161 161 148 132 132 132 132
132 132 132 132 132 161 38 67 132 132 132 132 132
132 161 132 132 132 132 132 161 132 132 148 132 132
132 132 161 132 132 132 161 132 132 132 132 161 132
132 114 132 132 132 132 161 132 64 67 78 161 132
132 132 161 132 161 161 161 132 161 132 132 148 132
132 132 132 132 132 132 132 132 161 132 132 148 132
132 132 132 135 132 132 132 132 161 132 132 132 132
132 132 161 132 132 132 132 132 161 132 132 132 132
4 67 77 132 67 88 132 132 161 132 25 67 86
