8 8
132 165 165 165 165 132 165 132
132 132 165 165 132 132 154 132
132 132 132 141 165 132 154 132
132 25 67 77 132 31 132 132
132 132 132 132 132 67 132 132
132 132 132 132 132 86 132 132
132 132 132 132 132 132 132 132
132 165 132 132 132 132 132 132
