8 8
132 132 132 132 132 132 132 135
132 132 132 132 132 132 132 132
132 148 132 132 132 132 132 132
132 132 148 132 132 132 132 132
114 132 132 148 132 132 132 132
132 132 132 132 132 25 67 86
4 67 77 132 132 132 132 132
132 132 132 132 132 132 132 132
