8 8
132 150 25 67 86 55 67 77
132 148 165 132 132 132 44 44
132 132 161 161 161 161 44 77
154 132 132 148 132 148 44 161
154 154 132 154 154 154 44 161
154 154 154 154 154 150 44 150
154 154 154 154 154 150 44 150
154 154 154 154 150 132 135 150
