8 8
132 132 132 132 132 132 132 132
132 132 132 132 132 132 132 132
150 150 150 150 150 150 150 150
40 132 132 132 132 132 4 132
67 132 132 132 114 132 67 132
89 132 132 132 132 132 90 132
132 132 132 132 132 132 132 132
4 67 77 132 132 25 67 86
