8 8
4 67 77 132 132 44 132 25
55 132 132 132 132 132 67 132
67 132 114 132 165 86 79 135
132 132 132 132 165 165 165 132
132 132 132 132 132 132 132 132
132 132 132 132 132 132 132 132
132 132 132 154 154 132 132 132
132 132 132 132 132 132 132 132
