13 9
114 132 132 132 132 132 132 132 132 132 25 67 90
132 132 51 132 4 132 51 132 55 132 44 67 89
67 132 51 132 67 132 67 132 67 132 44 67 83
78 132 51 132 77 132 79 132 78 132 25 67 86
132 132 132 161 132 161 132 132 132 132 64 67 78
132 132 132 132 132 132 132 132 132 132 132 67 132
132 132 132 132 132 132 132 132 132 132 55 67 55
132 132 132 132 165 132 132 132 132 132 132 132 132
154 132 132 132 135 132 132 165 154 132 132 132 132
