8 8
38 67 83 132 132 132 132 132
132 132 132 132 132 132 132 132
148 132 154 132 132 132 132 132
132 132 132 132 132 132 132 148
132 132 132 132 132 132 132 132
38 44 132 132 64 67 78 132
67 67 132 132 67 132 86 132
132 77 132 132 148 132 132 132
