8 8
132 132 132 132 132 132 25 132
135 132 132 132 132 132 132 132
132 132 114 132 132 132 132 135
132 132 132 132 132 132 51 132
132 161 132 132 132 132 67 67
132 67 132 4 67 77 132 132
67 132 132 114 132 132 132 132
86 132 132 132 132 132 132 132
