17 10
4 67 77 132 132 132 132 141 132 132 132 132 132 132 67 88 132
132 132 132 132 132 132 132 132 132 132 132 132 132 64 67 78 132
132 132 67 86 132 132 132 132 141 132 132 132 132 132 132 132 132
132 44 67 79 132 132 141 132 132 141 132 132 132 132 132 132 132
132 51 132 132 132 141 161 141 132 141 132 141 132 132 132 132 132
132 132 132 132 132 141 132 132 132 141 141 141 132 132 132 132 132
132 132 132 132 132 132 132 132 141 141 141 141 154 132 132 132 132
132 154 132 132 132 132 141 132 132 141 132 132 132 132 132 132 132
132 132 132 132 114 132 132 141 132 141 132 132 132 132 132 132 132
132 132 132 132 132 132 141 132 132 141 132 132 132 132 132 132 132
