8 8
25 67 86 132 132 132 132 132
132 132 132 132 132 132 132 132
132 132 132 132 132 132 132 132
132 114 132 132 132 132 132 132
132 132 132 132 132 132 132 132
132 132 132 132 132 4 67 77
132 132 132 132 132 132 132 132
135 132 132 132 132 132 132 132
