10 10
4 67 132 4 132 132 132 132 132 4
51 67 132 132 132 132 132 132 132 67
132 132 79 132 132 132 132 55 67 77
132 132 132 132 132 132 132 132 132 132
132 161 132 132 132 132 132 114 132 132
132 132 132 40 132 132 132 132 132 132
132 132 132 132 132 132 67 132 132 25
132 132 135 132 132 132 132 132 132 67
132 132 132 132 132 132 165 132 132 132
25 67 86 132 132 132 132 132 132 132
