8 8
114 132 132 132 132 132 135 132
132 132 132 132 132 44 67 77
132 132 132 132 132 132 132 132
25 67 86 132 132 132 132 132
132 132 132 132 132 132 132 132
132 132 132 132 132 132 132 132
132 132 132 132 132 132 132 132
132 132 132 132 132 132 132 132
