8 8
132 132 132 132 132 132 4 25
132 114 132 132 132 132 67 67
132 132 132 132 51 132 77 86
67 132 132 79 132 161 132 132
132 132 132 132 132 161 132 132
132 132 132 132 132 132 132 132
132 132 132 132 132 132 132 132
132 132 132 132 132 135 132 132
