8 8
44 132 77 141 132 132 67 77
4 67 77 141 154 25 132 132
114 154 132 141 132 132 132 132
141 141 141 141 141 141 141 141
132 132 132 141 132 132 132 132
161 132 51 141 132 31 132 132
31 67 78 141 67 132 132 132
31 67 88 86 77 135 86 132
