8 8
44 132 77 31 132 132 67 77
4 67 77 31 154 25 132 132
114 154 132 31 132 132 132 132
31 31 31 31 31 31 31 31
132 132 132 31 132 132 132 132
161 132 51 31 132 141 132 132
141 67 78 31 67 132 132 132
141 67 88 86 77 135 86 132
