8 8
25 67 86 132 132 132 132 135
132 132 132 132 150 150 44 132
132 132 132 132 150 150 67 150
132 132 132 132 150 150 77 150
132 132 132 150 150 150 132 150
132 132 132 150 150 150 150 150
132 132 132 132 132 132 132 132
132 132 132 132 132 132 132 132
