8 8
132 132 132 132 132 132 132 132
132 132 132 114 44 67 77 132
132 132 132 132 132 132 132 132
132 132 132 132 132 132 132 132
132 4 67 86 132 132 132 132
132 132 132 132 132 132 132 132
132 132 132 132 132 132 132 132
132 132 132 132 132 132 132 132
