8 8
132 132 132 132 132 132 132 132
25 67 77 132 132 132 132 132
132 132 132 132 86 132 132 132
132 132 132 132 44 67 132 132
132 132 132 132 132 132 132 132
132 132 132 132 132 132 132 132
132 132 132 135 132 150 132 154
132 132 132 132 132 150 132 132
