8 8
132 132 132 132 132 132 114 132
132 132 132 132 132 132 132 132
4 67 86 132 132 132 132 132
132 132 132 132 132 132 132 132
25 67 77 132 135 135 135 132
132 132 132 132 132 132 132 132
132 132 132 132 64 67 79 132
132 132 132 132 132 132 132 132
