8 8
132 132 132 132 132 132 132 132
67 132 132 132 67 132 132 132
88 132 132 40 132 132 132 25
132 132 132 132 132 132 132 67
132 132 132 132 132 132 132 86
132 132 132 132 132 132 132 132
150 150 132 132 4 67 77 132
135 150 132 132 132 132 132 132
