8 8
132 132 132 132 132 132 132 135
64 67 79 132 132 132 132 132
132 132 132 132 132 132 132 132
132 4 67 77 132 132 132 132
132 132 132 132 132 132 132 132
132 132 132 132 132 132 132 132
25 67 86 132 132 132 132 132
132 132 132 132 132 132 132 132
