10 10
141 67 89 132 31 132 132 132 132 132
4 67 90 132 132 132 132 31 132 132
67 165 165 165 132 31 132 132 31 132
77 38 67 86 132 44 67 86 31 132
132 132 132 132 132 132 132 31 132 132
31 31 31 31 31 132 132 132 31 132
31 132 132 132 132 31 31 44 31 154
132 132 31 31 132 31 31 67 31 154
31 132 114 31 132 31 132 89 31 154
31 31 31 31 132 132 132 31 148 154
