10 10
31 67 89 132 141 132 132 132 132 132
4 67 90 132 132 132 132 141 132 132
67 165 165 165 132 141 132 132 141 132
77 38 67 86 132 44 67 86 141 132
132 132 132 132 132 132 132 141 132 132
141 141 141 141 141 132 132 132 141 132
141 132 132 132 132 141 141 44 141 154
132 132 141 141 132 141 141 67 141 154
141 132 114 141 132 141 132 89 141 154
141 141 141 141 132 132 132 141 148 154
