8 8
132 132 132 132 132 132 132 132
132 132 132 132 135 132 132 132
44 67 77 132 132 154 132 132
132 132 132 132 132 132 132 132
132 132 132 132 132 132 132 132
25 67 86 132 132 132 154 132
132 114 132 154 132 132 132 132
132 132 132 132 64 67 79 132
