8 8
132 132 132 132 132 132 132 132
25 67 86 154 132 132 132 132
132 132 44 67 132 132 132 132
132 114 132 132 77 132 132 132
132 64 67 79 132 132 132 132
132 132 132 132 132 132 132 132
132 132 132 132 132 132 132 132
4 67 77 132 132 132 135 132
