8 8
135 132 132 132 132 132 132 25
132 132 132 132 132 132 67 67
132 132 161 132 132 132 88 86
132 132 132 132 132 132 132 64
161 132 132 132 132 132 132 67
132 64 67 90 132 51 67 78
132 132 67 89 132 67 132 132
114 4 67 77 114 79 132 132
