8 8
135 132 132 132 132 132 67 25
132 132 132 90 132 132 88 67
132 132 161 132 132 132 67 86
132 132 132 132 132 132 67 64
161 132 67 132 132 132 132 67
132 64 67 132 132 51 132 78
132 132 132 132 89 132 132 132
132 132 132 4 67 77 132 79
