8 8
132 132 25 67 86 132 132 132
150 150 150 150 150 150 150 150
132 132 40 67 132 132 132 132
132 132 132 132 132 132 132 132
132 132 132 132 132 132 132 132
132 132 132 132 132 132 132 132
132 132 132 132 132 132 132 132
132 4 67 77 132 132 132 135
