8 8
132 132 132 132 132 132 132 132
132 114 132 132 154 132 132 114
132 132 150 4 132 161 154 132
132 67 86 67 132 132 25 132
132 165 135 77 132 132 135 132
132 132 132 132 132 132 114 150
132 132 132 132 132 154 132 132
31 132 132 135 132 135 132 90
