8 8
132 4 132 132 132 132 132 132
132 67 132 132 25 67 86 132
132 77 132 132 51 132 132 132
132 132 132 132 132 132 132 132
132 132 132 132 132 132 141 132
132 132 132 132 132 132 132 132
132 132 132 132 132 132 132 132
132 132 132 135 132 132 132 132
