8 8
4 67 77 132 25 67 86 132
132 132 132 132 132 132 132 132
132 132 132 165 165 165 132 132
132 114 132 165 135 165 132 132
132 132 132 165 132 132 132 132
132 132 132 165 132 132 132 132
132 132 132 132 132 132 132 132
132 132 132 132 132 132 132 132
