10 10
4 67 77 132 132 132 132 132 132 55
38 67 77 132 132 132 132 132 132 67
25 67 78 132 132 132 132 132 83 132
132 132 132 132 132 132 132 132 132 132
132 67 132 132 132 132 132 132 132 132
67 132 132 132 132 132 165 132 132 132
132 88 132 86 132 165 114 165 132 132
132 132 132 132 132 132 165 132 132 132
132 132 132 132 132 132 132 132 132 132
132 132 132 132 132 132 132 132 132 132
