8 8
40 67 132 132 132 132 132 132
67 132 132 132 132 132 132 67
89 132 132 132 132 132 132 90
132 132 132 132 132 132 132 132
25 67 79 132 44 67 77 132
132 132 150 132 38 154 132 132
86 132 77 132 44 132 132 148
132 132 132 132 132 132 132 148
