8 8
165 132 132 55 132 132 31 132
148 132 132 132 132 132 132 150
132 132 132 132 132 132 114 132
40 132 132 132 132 114 132 132
132 132 165 132 132 135 165 132
132 132 132 132 4 132 132 150
114 132 132 132 67 161 132 132
132 67 86 132 77 114 132 132
