8 8
4 67 132 132 132 132 148 114
132 132 132 132 132 132 132 132
132 132 132 132 132 132 135 86
141 86 44 67 77 132 132 132
132 132 132 132 132 132 132 132
132 132 132 132 132 132 132 132
38 67 132 132 132 132 132 132
4 67 132 132 132 25 67 86
