8 8
132 51 161 114 150 150 132 135
40 67 89 132 150 150 150 132
132 79 132 132 150 150 132 161
132 132 161 132 150 150 132 67
132 132 161 132 150 150 132 150
132 25 132 132 150 150 132 4
4 67 90 132 150 150 132 67
161 86 161 132 132 132 132 77
