8 8
40 51 161 132 150 150 132 135
132 67 89 132 150 150 150 132
132 79 132 132 150 150 132 161
132 132 132 132 150 150 132 67
161 161 132 132 150 150 132 150
132 25 132 132 150 150 132 4
4 67 90 132 150 150 132 67
161 86 161 132 132 132 132 77
