8 8
44 67 77 132 161 132 132 132
51 132 161 161 77 161 132 132
67 161 132 132 132 132 132 132
132 132 132 132 161 161 132 154
132 132 132 25 67 86 31 31
161 132 132 132 132 132 132 132
31 132 132 161 31 161 31 161
135 31 161 132 161 31 161 31
