8 8
44 67 77 132 161 132 132 132
51 132 161 161 77 161 132 132
67 161 132 132 132 132 132 132
132 132 132 132 161 161 132 132
25 67 86 132 132 132 141 141
161 132 132 132 132 132 132 132
141 132 132 161 141 161 141 161
135 141 161 132 161 141 161 141
