8 8
4 67 77 132 132 132 67 88
132 132 132 132 132 132 132 132
132 132 132 132 114 132 67 132
25 132 165 161 132 161 79 132
132 132 165 161 132 51 132 132
132 132 165 132 132 132 132 132
132 132 165 165 165 165 132 132
132 67 86 55 67 132 67 25
