8 8
141 132 77 132 132 132 114 132
67 132 132 132 86 132 31 132
132 132 132 67 64 67 78 132
132 132 67 77 4 67 77 114
132 132 132 132 132 132 132 132
132 132 132 132 132 132 132 132
132 132 132 132 132 132 132 132
132 132 132 132 132 132 132 132
