10 10
4 67 77 132 132 132 132 132 132 55
4 161 132 132 132 132 132 132 132 67
51 132 132 135 132 132 132 132 132 25
132 132 132 132 132 132 132 132 132 67
132 67 132 132 132 132 132 132 132 86
67 132 132 132 132 132 165 132 135 132
132 88 132 86 132 165 114 165 132 25
132 132 132 132 132 132 165 132 132 132
132 132 132 132 67 86 132 132 132 132
132 132 132 132 132 132 132 132 132 132
