8 8
148 4 38 132 132 132 114 132
132 132 67 132 132 132 132 132
132 132 77 132 132 132 132 132
132 132 132 132 132 132 44 132
132 132 132 132 132 132 67 132
132 132 132 132 132 132 86 132
64 67 89 132 132 132 132 132
132 132 132 132 132 4 67 90
