8 8
114 132 132 150 165 150 150 135
132 132 132 150 165 150 150 150
132 55 132 150 165 150 150 150
40 67 89 150 165 150 150 150
132 78 132 150 165 132 132 132
25 132 132 132 132 132 132 132
67 132 132 132 132 132 132 132
86 132 4 67 77 132 132 132
