8 8
4 38 67 86 132 132 132 132
67 161 161 161 132 132 51 67
77 161 114 161 132 51 67 78
132 161 161 161 132 132 83 132
132 132 132 132 132 161 132 132
132 132 132 132 132 132 132 132
132 132 132 132 161 132 132 161
132 161 132 161 132 161 132 148
