8 8
114 132 31 132 31 4 67 77
132 31 132 31 132 31 132 31
31 132 31 132 31 132 31 132
132 31 132 31 132 31 132 31
31 132 31 132 31 132 31 132
132 31 132 31 132 31 132 31
31 132 31 132 31 132 31 132
25 67 86 31 132 31 132 135
