8 8
132 132 141 132 141 4 67 77
132 141 132 141 132 141 132 141
141 132 141 132 141 132 141 132
132 141 132 141 132 141 132 141
141 132 141 132 141 132 141 132
132 141 132 141 132 141 132 141
141 132 141 132 141 132 141 132
25 67 86 141 132 141 132 135
