8 8
132 132 132 132 132 132 132 132
132 31 31 31 31 31 132 67
132 31 31 114 31 31 132 86
132 31 31 31 31 31 132 132
132 132 132 132 132 132 132 132
132 141 132 132 132 132 132 132
132 67 132 132 132 132 132 132
132 77 132 132 132 4 67 77
