18 18
150 150 150 150 150 150 135 135 132 132 132 132 132 132 132 132 40 132
150 132 132 132 132 150 135 135 132 132 132 132 132 132 132 132 67 132
150 114 132 132 132 150 135 135 132 132 132 132 132 132 132 132 79 132
150 132 132 132 132 150 135 135 132 132 132 132 132 132 132 132 132 132
150 132 67 79 132 150 135 135 132 132 132 132 132 132 132 132 132 132
150 150 150 150 150 150 135 135 132 132 132 132 132 132 132 132 132 132
135 135 135 135 132 132 132 132 132 132 132 132 132 132 132 132 132 132
135 135 135 135 132 132 132 132 132 132 132 132 132 132 132 132 132 132
132 132 132 132 132 132 132 132 132 132 132 132 132 132 132 132 132 132
132 132 132 132 132 132 132 132 132 25 132 86 132 132 132 132 132 132
132 132 4 67 77 132 132 132 132 132 67 132 132 132 132 132 132 132
132 132 132 132 132 132 132 132 132 132 132 132 132 132 132 132 132 132
132 132 132 132 132 132 132 132 132 148 132 132 132 132 132 132 132 132
132 132 132 132 38 67 77 132 132 132 132 132 132 132 132 132 132 132
132 132 132 132 132 132 132 132 132 132 132 132 132 132 132 132 132 132
132 132 132 132 132 132 132 132 132 132 132 132 132 132 132 132 132 132
132 132 132 132 132 132 132 132 132 132 132 132 132 132 132 132 83 132
132 132 132 132 132 132 132 132 132 132 132 132 132 132 132 132 132 132
