8 8
38 51 132 132 132 132 161 165
67 67 132 132 132 132 161 161
132 79 132 132 132 132 132 132
132 4 67 86 132 132 132 132
132 132 132 132 132 55 67 77
40 132 132 132 150 132 132 132
67 132 148 148 150 132 148 132
88 114 132 150 150 132 148 132
