8 8
44 4 67 77 132 132 132 86
67 132 132 132 132 132 132 132
132 132 132 132 154 38 67 78
132 132 132 132 132 132 132 132
154 132 114 132 132 148 148 132
132 132 132 132 132 132 132 132
132 132 154 132 132 154 132 132
132 132 132 132 132 132 132 132
