8 8
135 132 148 132 148 132 148 148
132 4 67 77 25 67 86 132
148 132 132 132 132 132 132 148
132 132 132 132 132 132 132 132
148 132 132 132 132 132 132 148
132 132 132 132 132 132 132 132
148 132 132 132 132 132 132 148
132 38 67 132 38 67 83 132
