8 16
135 135 135 135 135 135 135 135
64 67 78 132 132 132 132 132
4 148 132 132 132 132 132 132
67 132 148 132 132 132 148 132
77 132 132 132 148 132 132 132
132 132 132 132 132 132 132 132
132 132 132 148 132 132 132 132
38 148 132 132 132 132 132 148
67 148 132 132 132 148 132 132
83 132 132 132 132 132 132 132
132 132 132 132 132 132 132 132
132 132 132 132 132 132 132 132
25 67 86 132 132 132 148 132
38 132 132 148 132 132 132 132
67 132 132 132 132 132 132 132
132 132 132 132 148 148 132 114
