8 8
132 135 148 132 132 132 132 132
150 132 132 150 132 132 150 132
165 150 150 165 150 150 165 150
132 165 132 132 132 132 132 132
132 132 132 132 114 132 165 132
64 67 78 25 67 86 132 132
132 132 4 67 90 55 67 132
40 67 89 132 132 4 67 77
