8 18
148 148 132 148 132 148 148 148
150 150 132 132 132 132 132 148
132 150 132 132 132 132 132 148
132 150 132 132 132 132 132 148
132 150 150 150 150 132 132 148
132 132 150 132 132 132 132 132
132 132 150 132 150 150 150 150
132 132 150 132 150 150 150 150
132 132 132 132 150 150 150 150
132 132 132 132 132 132 132 132
132 132 132 132 132 132 132 132
40 67 78 132 132 132 132 132
132 132 132 132 132 132 132 132
132 132 132 132 132 132 132 132
4 38 67 86 132 132 132 132
67 132 132 132 132 132 132 132
77 132 38 67 83 132 132 132
114 132 132 132 132 132 132 132
