11 11
132 132 132 132 4 67 77 132 132 132 132
132 132 132 132 132 132 132 132 132 132 132
132 132 132 132 161 132 161 132 132 132 132
132 132 132 132 132 132 132 132 132 132 132
64 132 51 132 132 114 132 132 51 132 4
67 132 132 132 132 132 132 132 132 132 67
78 132 132 132 132 132 132 132 132 132 77
132 132 132 132 132 132 132 132 132 132 132
132 67 132 132 132 132 132 132 132 67 132
132 132 132 132 132 132 132 132 132 86 132
132 132 132 132 51 67 79 132 132 132 132
