11 11
4 67 77 25 67 86 135 40 67 83 132
132 132 132 132 132 132 132 132 132 132 132
150 132 150 132 150 150 132 150 150 132 132
132 132 132 132 132 132 132 132 132 132 132
150 132 150 132 132 150 132 132 150 132 132
150 132 132 150 132 132 150 132 132 132 132
132 150 132 132 132 132 132 150 132 150 132
150 150 132 150 132 150 132 150 132 132 150
132 132 132 132 132 132 132 132 132 132 132
132 132 132 132 132 132 132 132 132 132 132
114 132 132 132 4 67 90 132 40 67 89
