8 8
132 132 114 132 132 132 132 132
4 67 77 132 132 132 132 132
38 67 132 132 132 148 132 132
132 132 132 132 132 132 132 132
132 132 132 132 132 132 132 25
132 132 132 132 132 135 132 67
132 132 132 132 132 132 132 86
64 67 83 132 132 132 132 132
