11 18
4 67 77 55 67 132 25 67 86 132 132
55 67 83 132 67 132 64 67 78 114 132
132 132 132 132 132 132 132 132 132 132 132
132 132 132 132 132 132 132 132 132 165 132
132 132 132 132 132 132 132 132 165 132 132
132 132 132 132 132 132 132 165 132 132 132
132 132 132 132 132 132 165 132 132 132 132
132 132 132 132 132 132 132 165 132 132 132
132 132 132 132 132 132 132 132 165 132 132
132 132 132 132 132 132 132 132 132 165 132
132 132 132 132 132 132 132 132 165 132 132
132 132 132 132 132 132 132 165 132 132 132
132 132 132 132 132 132 165 132 132 132 132
132 132 132 132 132 132 132 165 132 132 132
132 132 132 132 132 132 132 132 165 132 132
132 132 132 132 132 132 132 132 132 165 132
132 132 132 132 132 132 132 132 165 132 132
132 132 132 132 132 132 132 132 132 135 132
