11 18
4 67 77 55 67 132 25 67 86 132 132
67 78 132 132 132 132 132 132 132 132 132
132 132 132 132 132 132 165 132 132 132 132
132 132 132 132 132 132 132 132 165 132 132
165 132 132 132 132 132 132 132 132 132 132
132 132 132 132 132 132 165 132 132 132 132
165 132 132 132 132 132 132 132 132 132 165
132 132 165 132 132 132 132 132 132 132 132
132 132 132 132 132 132 165 132 132 132 132
165 132 132 132 132 132 132 132 132 132 132
132 132 132 132 165 132 132 132 132 132 132
