8 8
25 64 132 132 132 132 132 132
67 67 132 132 132 135 132 132
86 78 132 132 132 132 132 132
132 67 88 132 148 132 132 132
132 132 132 132 132 132 132 132
132 4 38 132 132 132 132 132
132 67 67 132 132 132 132 132
132 77 148 132 132 132 132 132
