8 8
4 67 77 132 132 132 114 132
132 132 132 132 132 132 25 132
165 132 165 132 132 132 67 132
132 135 132 132 132 132 86 132
165 132 165 132 132 132 132 132
132 132 132 132 132 132 132 132
132 132 132 132 132 67 132 132
132 132 132 132 132 132 132 132
