18 8
132 132 132 132 132 135 132 132 132 132 38 132 114 132 132 132 132 132
132 4 67 77 132 132 25 67 86 132 67 132 132 132 132 132 64 132
132 132 114 132 132 132 132 132 132 31 67 77 132 132 132 132 67 132
40 51 132 132 44 132 132 132 132 132 86 132 132 132 132 132 78 161
67 67 132 4 161 67 132 132 132 132 132 132 148 132 132 132 132 132
132 79 67 132 86 132 132 150 150 150 150 132 132 132 132 132 132 132
132 132 132 150 132 132 132 150 150 150 150 150 150 150 132 132 132 132
150 150 150 150 132 154 132 150 150 150 150 150 150 132 38 67 83 132
