9 8
132 25 132 132 132 132 44 132 132
132 67 132 132 132 132 67 132 132
132 132 132 132 132 132 77 132 132
132 132 132 132 132 132 132 132 132
132 132 154 132 132 132 132 64 132
132 132 154 132 132 132 132 67 132
132 132 132 132 132 67 89 78 132
135 132 132 132 132 132 25 67 86
