8 8
132 165 135 132 141 150 161 132
148 132 132 4 55 132 64 31
51 132 38 132 44 25 67 86
78 83 79 88 132 77 90 132
132 132 132 132 132 89 132 132
132 132 132 132 132 132 64 132
132 132 132 132 154 132 67 132
4 67 77 44 67 86 78 132
