8 8
132 132 132 132 132 132 132 132
55 77 132 132 4 67 77 132
132 132 132 132 165 132 132 132
132 132 132 83 132 132 132 132
132 67 132 154 132 132 44 132
132 86 154 114 64 67 132 78
132 132 132 154 132 132 77 132
44 67 132 132 132 132 67 78
