8 8
132 77 132 132 132 132 132 132
55 67 86 132 4 67 77 132
132 132 132 132 165 132 132 132
132 132 132 83 132 132 132 132
132 132 132 154 132 132 44 132
132 132 154 132 132 64 67 78
132 132 132 154 132 132 77 132
44 67 132 132 132 132 67 78
