18 18
64 132 132 132 132 132 132 132 132 132 132 132 132 132 132 132 132 132
67 132 132 132 132 132 132 132 132 132 132 132 132 132 132 132 38 132
78 132 38 67 83 132 132 132 132 132 51 67 132 132 132 89 67 132
38 132 148 132 132 132 86 132 132 132 132 132 86 132 67 132 90 132
67 132 148 132 132 132 132 132 132 132 132 132 132 132 132 132 132 132
132 132 132 67 148 114 148 132 132 132 141 141 141 141 132 132 132 132
31 132 132 132 132 132 132 132 132 132 132 132 132 132 132 132 132 132
67 132 132 132 132 132 132 132 132 132 114 132 132 132 132 132 132 132
90 132 132 132 132 132 132 132 132 132 132 132 165 132 132 132 132 132
31 132 132 132 132 132 132 132 132 132 132 132 150 132 132 132 132 132
67 132 114 132 132 132 132 132 132 132 132 132 132 132 132 132 132 132
132 132 132 132 132 132 132 132 132 132 132 114 132 51 132 132 132 132
55 132 132 132 132 132 132 132 132 132 132 161 132 67 132 132 132 132
67 132 132 132 132 132 132 132 132 132 132 132 132 79 40 132 132 132
132 132 161 161 161 161 161 161 132 132 132 132 132 132 67 132 132 132
4 132 161 161 135 161 161 161 132 132 132 132 132 132 89 132 132 132
67 132 132 132 132 132 132 132 132 132 132 132 132 132 132 132 132 132
90 51 67 90 25 67 86 40 67 89 51 67 132 4 67 77 132 132
