8 8
38 25 67 86 38 67 38 132
67 135 132 132 132 132 132 132
132 132 132 132 132 132 132 148
4 132 132 38 67 114 132 132
67 132 132 141 31 132 78 132
77 64 132 154 44 132 77 132
132 67 132 132 132 132 88 132
132 78 132 150 40 132 89 132
