8 8
38 25 67 86 38 67 38 132
67 135 132 132 132 132 132 132
132 132 132 132 132 132 132 148
4 132 132 38 67 77 132 132
67 132 132 141 31 132 132 78
77 64 132 154 44 132 88 132
132 67 132 132 132 132 132 132
132 78 132 150 40 89 132 132
