8 18
64 55 40 150 150 150 150 150
67 67 67 150 150 150 150 148
79 79 78 150 150 38 67 77
150 150 150 150 150 4 67 83
150 150 150 150 150 38 67 132
150 150 150 148 148 150 150 150
150 150 150 132 132 150 150 150
25 150 150 165 165 150 150 25
67 132 132 132 132 132 132 67
86 132 132 132 132 132 132 86
135 132 132 132 132 132 132 135
132 132 132 132 132 132 132 132
132 132 132 132 132 132 132 132
132 132 132 132 132 132 132 132
132 132 132 132 132 132 132 132
132 4 132 132 132 132 132 55
67 67 132 114 132 132 67 67
89 90 132 132 132 132 79 89
