8 18
64 55 40 150 150 150 150 150
78 150 150 38 67 148 150 150
150 38 67 83 150 150 150 132
150 150 25 150 150 165 165 150
86 132 132 132 132 132 132 86
132 132 132 132 132 132 132 132
132 132 132 132 132 132 132 132
132 55 67 67 132 132 132 132
