10 10
40 132 148 132 4 132 132 38 67 161
132 132 161 132 132 86 132 135 132 165
132 55 67 132 132 132 132 132 165 67
132 132 161 132 64 67 132 132 165 132
64 132 114 132 132 132 132 132 132 132
148 148 132 132 161 114 132 135 135 79
90 132 4 67 77 132 132 132 132 132
132 114 132 135 132 165 132 132 132 67
132 132 132 132 132 132 132 132 132 88
154 132 132 132 132 51 25 67 132 135
