8 8
38 67 132 132 132 132 132 132
67 148 132 132 148 132 132 132
132 114 132 40 132 132 148 132
132 141 67 79 132 132 31 31
132 114 132 132 132 132 114 132
148 132 132 132 25 132 148 132
132 132 148 132 67 132 132 132
4 67 77 132 150 135 67 86
