8 8
38 67 132 132 132 132 132 132
67 148 132 132 148 132 132 132
132 132 132 132 40 132 148 132
132 31 67 132 132 132 141 141
132 132 132 79 132 132 132 132
148 132 132 132 132 132 148 132
132 132 148 132 132 114 132 114
4 67 77 132 150 135 67 86
