18 18
64 132 154 154 154 154 154 154 154 135 154 154 154 154 154 154 154 154
67 132 154 154 154 154 154 154 154 132 154 154 154 154 154 154 154 154
78 132 154 154 154 154 154 154 154 132 154 154 154 154 154 154 154 154
25 132 154 154 154 154 154 154 154 132 154 154 154 154 154 154 154 154
67 132 154 154 154 154 154 154 154 132 154 154 154 154 154 154 154 154
86 132 154 154 154 154 154 154 154 154 154 154 154 154 154 154 154 154
44 132 154 154 154 154 154 154 154 154 154 154 154 154 154 154 154 154
67 132 154 154 154 154 154 154 154 154 154 154 154 154 154 154 154 154
132 132 154 154 154 154 154 154 154 154 154 154 154 154 154 154 154 154
132 132 154 154 154 154 154 154 154 154 154 154 154 154 154 154 154 154
132 132 132 132 132 132 132 132 132 132 132 132 132 132 165 132 132 132
132 132 132 132 132 132 161 132 161 132 132 132 132 132 165 55 132 132
132 132 132 114 132 132 161 161 161 132 132 132 132 132 165 67 132 132
132 132 4 67 77 132 132 51 132 132 132 132 132 132 165 132 132 132
132 132 132 132 132 132 132 67 132 132 132 132 132 132 165 132 132 132
132 132 132 132 132 132 132 79 132 132 132 67 132 132 165 132 132 132
132 132 132 132 132 132 132 132 132 132 132 132 132 132 132 132 132 132
132 132 132 132 132 132 132 132 132 132 132 132 132 132 132 132 132 132
