10 5
64 25 25 4 132 132 132 132 132 132
67 67 67 67 132 132 4 4 132 132
78 86 89 90 132 114 67 67 135 132
4 67 38 67 77 132 4 4 132 132
4 67 77 132 132 132 132 132 132 132
