18 18
38 67 88 161 132 132 132 132 132 132 132 132 132 132 132 132 132 132
67 161 161 161 161 161 161 132 132 132 132 132 132 132 132 132 132 132
132 132 132 132 132 132 161 132 132 132 132 132 132 132 132 132 132 132
67 161 161 161 132 161 161 132 132 132 132 132 132 132 132 132 132 132
88 161 132 132 132 132 132 132 132 132 132 132 132 132 132 132 132 132
161 161 132 132 132 132 132 132 132 132 132 132 132 132 132 132 132 132
132 132 132 44 132 132 132 132 132 132 132 148 148 148 148 148 132 132
132 132 132 67 132 132 132 132 132 132 132 148 148 148 148 148 132 132
132 132 132 86 132 132 132 132 132 132 154 148 148 150 148 148 132 132
132 132 132 132 67 77 132 132 132 132 132 148 148 148 148 148 132 132
132 132 132 132 132 132 132 132 132 132 132 148 148 148 148 148 132 132
132 132 132 132 132 161 161 161 165 161 161 161 132 132 132 132 132 132
132 132 132 132 132 161 132 132 132 132 132 161 132 132 132 132 132 132
132 132 132 132 132 161 132 161 132 161 132 161 132 132 132 132 132 132
161 161 161 161 161 161 161 161 31 161 161 161 132 132 132 161 161 161
44 67 79 40 161 161 161 161 132 161 161 161 161 161 161 161 55 132
64 67 79 67 161 161 161 161 67 161 161 161 161 141 67 67 132 132
51 67 78 86 161 161 161 161 83 161 161 161 161 161 161 161 78 79
