18 18
40 67 89 4 67 90 64 67 78 25 67 86 132 132 132 132 132 132
132 132 132 67 132 132 132 132 132 132 132 132 132 132 132 132 132 132
132 132 132 77 132 132 132 132 132 132 132 132 132 132 132 132 132 132
132 161 132 132 132 132 114 132 132 132 132 132 132 132 132 132 132 132
132 161 132 132 132 132 132 132 132 132 132 132 132 132 132 132 132 132
132 132 132 132 132 132 132 132 132 132 132 132 132 132 132 132 132 132
132 132 132 132 132 132 132 132 132 132 132 132 132 132 132 132 132 132
132 132 132 132 51 132 132 40 67 132 132 132 132 150 150 150 150 150
132 132 132 132 67 132 132 132 132 132 132 132 132 150 150 150 150 150
132 132 83 132 79 132 132 132 132 132 132 132 132 150 150 150 150 150
132 132 132 132 132 132 132 132 132 132 132 132 132 150 150 150 150 150
132 132 132 132 132 132 132 132 132 132 132 132 132 150 150 150 150 150
132 132 132 132 132 132 132 132 132 132 132 132 132 150 150 135 150 150
132 132 132 132 132 132 132 132 132 132 132 132 132 150 150 150 150 150
132 132 132 132 132 132 132 132 132 132 132 132 132 150 132 132 132 150
132 132 132 132 132 132 132 132 132 132 132 132 132 150 132 132 132 150
132 132 132 132 132 132 132 132 132 132 132 132 132 132 132 132 132 150
132 132 132 132 132 132 132 132 132 132 132 132 132 132 132 132 132 132
