18 18
64 67 78 4 141 40 132 25 38 132 132 132 165 132 132 132 154 132
44 67 79 67 67 67 67 67 67 67 132 55 67 77 132 132 67 132
132 51 67 79 83 132 89 86 90 79 132 55 132 83 132 4 161 77
132 132 132 132 132 132 132 132 132 132 132 132 132 132 132 44 67 77
132 154 132 132 132 132 132 132 132 132 132 132 132 132 132 132 132 132
38 132 79 132 132 132 132 132 132 132 132 132 132 132 132 132 132 132
132 67 132 132 44 132 132 132 132 132 132 132 132 132 132 132 132 132
132 161 161 67 161 67 132 132 132 132 132 132 132 132 132 132 132 132
132 114 132 132 83 132 83 132 132 132 132 132 132 132 132 132 132 132
132 132 132 132 132 132 132 132 132 132 132 132 132 132 132 132 132 132
132 154 132 132 132 132 132 165 132 132 132 132 132 132 132 132 132 132
132 132 132 132 132 132 148 132 132 132 132 132 132 132 132 132 132 132
38 67 83 132 132 132 132 132 132 132 132 132 132 132 132 132 132 132
132 161 132 132 132 132 132 132 132 132 135 132 132 132 132 132 132 132
132 114 132 132 132 132 132 31 132 150 132 132 132 132 132 132 132 132
132 132 132 132 132 132 132 132 132 132 132 132 132 132 132 132 132 132
132 132 132 132 132 132 132 132 132 132 132 132 132 132 132 132 114 132
132 132 132 132 132 132 132 132 132 132 132 132 132 132 132 132 132 132
