11 11
132 132 132 132 132 77 132 132 132 132 132
132 114 132 132 132 25 132 132 132 132 132
132 132 132 132 132 132 83 67 77 132 132
132 4 132 132 132 132 132 132 132 132 132
132 132 132 132 55 132 132 132 132 132 25
132 132 132 132 132 132 132 132 55 132 67
132 132 132 132 132 38 67 77 132 132 132
132 114 132 64 132 132 132 132 132 132 132
132 132 132 132 132 132 132 132 165 132 132
132 132 132 132 132 4 67 77 165 86 148
132 132 132 132 132 132 132 132 132 132 148
