18 18
114 132 150 150 150 132 132 132 132 150 132 132 132 132 132 150 132 150
132 132 132 132 132 132 132 132 132 132 132 132 132 132 132 150 132 150
132 132 132 132 132 150 132 150 150 132 132 132 150 150 132 150 132 150
132 132 132 150 132 132 132 132 132 150 132 132 132 132 132 150 132 150
132 132 132 132 132 150 150 150 132 150 132 150 132 132 150 150 132 150
132 132 132 150 150 150 132 132 132 150 132 132 150 132 150 132 150 150
132 150 132 132 132 150 132 150 132 150 132 150 132 132 150 150 150 150
132 150 132 132 132 150 132 150 132 132 132 132 150 132 150 132 132 132
132 132 132 132 150 150 132 132 132 132 150 150 150 132 150 132 150 150
132 132 150 150 132 150 132 132 132 132 135 132 150 132 150 132 132 150
132 150 132 132 132 132 150 150 132 150 132 132 150 132 150 132 150 150
132 150 132 132 132 150 132 132 132 150 132 150 150 150 150 150 150 132
132 132 132 132 132 132 132 132 132 132 132 132 132 132 132 132 132 132
132 132 132 132 132 132 132 132 132 132 132 132 132 132 132 132 132 132
132 132 132 132 132 132 132 132 132 132 132 132 132 132 132 132 132 132
132 40 132 132 31 132 132 132 132 132 132 40 67 132 51 67 79 132
154 67 161 67 154 132 132 132 132 132 132 64 67 78 4 67 77 132
132 132 132 31 40 132 132 132 132 132 132 44 67 83 25 67 86 132
