18 18
132 132 132 132 132 132 132 132 132 132 132 132 132 132 132 132 132 132
132 132 132 132 132 132 132 132 135 132 132 132 132 132 132 132 132 132
132 132 132 132 132 132 132 132 132 132 132 132 132 132 132 132 132 132
132 132 132 132 132 132 132 132 132 132 132 132 132 132 132 132 132 132
132 132 132 132 132 51 132 132 161 51 132 132 132 132 132 132 132 132
132 132 132 132 132 67 132 67 132 67 132 67 132 132 132 132 132 132
132 132 132 132 132 51 132 78 132 79 132 132 132 132 132 132 132 132
132 132 132 132 132 132 132 132 132 132 132 132 132 132 132 132 132 132
132 132 132 132 132 132 141 132 132 132 132 132 132 132 132 132 132 132
132 132 132 132 132 132 141 141 141 141 141 132 132 132 132 132 132 132
132 132 132 132 132 132 132 132 132 132 141 132 132 132 132 132 132 132
132 132 132 132 132 132 141 141 141 141 141 132 132 132 132 132 132 132
132 132 132 132 132 132 132 132 132 132 132 132 132 132 132 132 132 132
132 132 132 132 132 31 67 78 132 132 132 132 132 132 132 132 132 132
132 132 132 132 132 132 132 132 132 25 67 86 132 132 132 132 132 132
25 67 90 132 132 132 132 114 132 132 132 132 132 132 132 132 132 132
4 67 90 132 132 132 132 77 132 132 132 132 132 132 132 4 67 77
132 67 89 132 132 132 132 132 132 132 132 132 132 132 132 64 67 78
