8 8
40 67 132 132 51 64 25 4
132 132 67 132 67 67 67 67
132 161 40 161 83 78 86 77
132 132 132 132 132 40 67 132
114 132 150 150 132 132 135 132
150 132 150 132 150 132 150 150
150 132 150 132 150 132 132 150
150 150 132 132 150 150 132 150
