8 8
64 4 67 77 132 25 67 86
67 132 132 132 132 132 135 132
78 132 51 67 79 132 132 132
132 132 132 132 132 161 132 132
132 132 67 132 114 132 132 132
132 132 132 132 132 150 132 132
132 79 132 132 132 132 132 132
132 132 132 67 88 40 67 132
