8 8
132 132 132 132 132 132 132 132
132 132 132 132 132 132 132 132
132 114 132 132 132 132 135 132
132 132 132 132 132 132 132 132
132 132 132 132 132 132 132 132
132 132 132 132 132 132 132 132
132 64 67 78 40 67 132 132
132 4 67 77 25 67 86 132
