18 10
132 132 132 132 150 132 132 132 132 132 132 132 132 132 132 132 132 132
132 132 132 132 150 132 132 55 67 132 77 132 132 132 132 132 132 132
132 132 132 132 132 132 132 148 132 132 132 132 132 132 51 67 79 132
132 132 132 4 38 132 132 132 132 132 132 132 132 132 132 132 132 132
132 132 132 67 67 132 132 132 132 132 132 132 132 132 132 132 132 132
132 132 161 77 132 132 132 132 132 132 132 132 132 132 132 132 150 135
132 132 132 132 132 132 132 67 88 40 67 89 132 132 132 132 132 132
132 114 132 25 67 86 64 67 78 4 67 90 132 165 132 132 132 132
132 132 132 132 132 132 132 132 132 132 132 132 132 132 132 132 132 132
132 132 132 132 132 132 132 132 132 132 132 132 132 132 132 132 132 132
