18 10
132 132 132 132 150 132 132 132 132 132 132 132 132 132 132 132 132 132
132 132 132 132 132 132 132 132 132 132 132 132 150 132 132 55 67 77
132 132 150 132 132 55 67 77 148 132 132 132 132 132 132 132 132 132
132 132 132 132 132 132 132 132 132 132 132 132 132 132 132 132 132 132
132 132 132 132 132 132 132 132 132 132 51 67 79 132 132 132 132 4
51 67 79 132 132 132 132 4 38 132 132 132 132 132 132 132 132 132
132 132 132 132 132 132 132 132 132 132 132 132 132 132 132 67 67 132
132 132 132 132 132 67 67 132 132 132 132 132 132 132 132 132 132 132
132 132 132 132 132 132 132 132 132 165 132 132 114 132 132 132 132 132
132 132 114 132 132 132 132 132 132 132 132 132 132 132 132 132 150 135
