18 18
114 114 114 114 114 114 114 114 114 114 114 114 114 114 114 114 114 114
114 114 114 114 114 114 114 114 114 114 114 114 114 114 114 114 114 114
114 114 114 114 114 114 114 114 114 114 114 114 114 114 114 114 114 114
114 114 114 114 114 114 114 114 114 114 114 114 114 114 114 114 114 114
114 114 114 114 114 114 114 114 114 114 114 114 114 114 114 114 114 114
114 114 114 114 114 114 114 114 114 114 114 114 114 114 114 114 114 114
114 114 114 114 114 114 114 114 114 114 114 114 114 114 114 114 114 114
114 114 114 114 114 114 114 114 4 114 114 114 114 114 114 114 114 114
114 114 114 114 114 114 114 38 67 77 114 114 114 114 114 114 114 114
114 114 114 114 114 132 67 88 77 114 114 114 114 114 114 114 114 114
114 114 132 132 132 132 132 132 132 132 114 114 114 114 114 114 114 114
114 114 132 132 132 132 132 132 132 132 114 114 114 114 114 114 114 114
114 114 132 132 132 132 132 132 132 132 114 114 114 114 114 114 114 114
114 114 132 25 132 132 135 132 132 132 114 114 114 114 114 114 114 114
114 114 132 132 132 132 132 132 132 132 114 114 114 114 114 114 114 114
114 114 132 132 132 132 148 132 132 132 114 114 114 114 114 114 114 114
114 114 132 132 132 132 132 132 86 132 114 114 114 55 67 64 114 114
114 114 132 132 132 132 132 132 132 132 114 114 114 64 67 55 67 78
