9 8
132 132 132 132 132 132 132 161 132
132 132 132 114 132 132 132 161 161
132 132 132 132 132 132 132 161 161
132 161 161 161 161 161 161 161 161
161 161 161 161 161 161 161 161 161
132 51 132 161 161 161 161 161 161
132 67 132 161 161 161 132 132 25
132 79 132 161 161 161 132 4 67
