13 13
154 132 132 132 132 132 150 132 132 132 51 67 79
44 67 86 132 132 132 150 132 132 132 132 132 132
132 132 132 132 132 132 150 132 114 161 161 161 132
132 132 132 150 150 150 150 132 161 161 40 161 161
132 132 150 150 132 132 132 132 161 64 67 78 161
132 132 150 132 132 132 132 132 161 161 89 161 161
150 150 150 132 132 132 132 132 132 161 161 161 132
150 132 132 132 132 132 132 38 67 83 132 132 132
132 132 132 132 132 132 132 132 132 132 132 132 132
132 132 132 132 132 132 4 132 132 132 132 132 132
132 132 132 132 148 4 67 77 132 132 132 64 132
132 132 132 132 132 132 90 132 132 132 40 67 88
132 132 132 132 132 132 132 132 132 132 132 132 132
