8 8
44 67 86 132 132 132 132 132
132 132 132 132 132 132 148 132
132 38 4 132 132 132 132 132
132 77 67 132 132 132 154 132
132 55 77 132 132 132 132 132
132 132 132 132 132 132 132 38
132 114 132 132 132 132 132 67
132 67 132 132 132 132 132 132
