8 8
4 67 77 132 132 25 67 86
132 132 132 132 132 132 132 132
132 132 132 132 132 132 132 132
132 132 132 135 132 132 132 132
132 132 132 132 132 132 132 161
132 132 132 132 132 132 132 132
132 132 132 132 132 132 132 132
64 67 78 132 132 51 67 79
