8 8
132 132 132 132 51 67 79 132
4 132 132 132 132 132 132 25
67 132 64 67 78 132 132 67
77 132 132 132 132 132 132 86
132 132 132 132 132 132 132 132
114 132 161 161 161 132 132 135
132 132 132 132 132 132 132 132
132 132 132 132 132 132 132 132
