14 8
64 132 132 132 132 132 132 132 132 132 132 132 132 132
132 132 132 132 132 132 67 132 132 132 132 132 132 132
132 132 132 132 132 132 132 132 132 132 132 132 78 132
132 132 132 132 78 132 132 132 132 132 132 161 132 132
132 132 132 161 132 132 132 132 132 132 132 132 132 132
132 132 132 132 132 132 132 132 132 132 132 132 132 135
132 132 132 132 132 135 132 132 132 132 132 161 161 161
132 132 132 161 161 161 161 132 161 161 161 132 132 132
