15 6
132 132 132 132 132 132 132 165 132 132 132 132 25 132 132
132 154 132 132 132 135 132 165 132 132 132 132 67 132 132
132 132 132 83 132 132 132 165 132 132 86 67 78 132 132
132 132 132 132 132 132 132 165 132 132 132 132 132 132 132
132 148 132 38 67 79 132 165 132 132 132 132 55 67 132
132 132 132 132 132 132 132 165 132 38 67 132 44 67 77
