8 8
4 132 114 132 132 67 86 132
67 132 132 132 132 132 132 132
77 132 132 132 132 132 132 132
132 132 132 132 25 132 132 132
132 132 132 132 132 132 132 132
132 132 132 132 132 132 132 132
132 132 135 132 132 132 132 132
132 132 132 132 132 132 132 132
