8 8
25 67 86 132 132 132 132 132
4 67 77 44 67 79 132 132
132 132 132 132 132 132 132 132
135 132 132 132 132 132 132 132
132 132 132 154 132 132 132 132
51 67 79 132 132 132 132 64
132 132 132 132 132 132 132 67
114 132 132 132 132 132 132 78
