18 18
132 132 132 132 132 132 132 132 132 132 132 67 132 132 132 132 132 132
132 132 132 132 132 132 132 132 132 132 4 132 132 132 132 132 132 132
132 132 132 132 132 132 132 132 132 132 132 132 132 132 132 132 132 132
132 132 132 132 132 132 132 132 132 132 132 132 132 132 132 132 132 132
132 132 132 132 132 132 132 132 132 132 114 132 114 132 132 132 4 132
132 132 132 132 132 132 132 4 132 114 132 132 132 132 132 132 132 67
132 132 132 132 132 132 67 132 132 132 132 114 132 132 132 132 132 132
132 132 132 132 132 132 132 132 132 132 132 4 132 132 132 132 132 132
132 132 132 132 132 132 132 132 132 132 132 132 67 132 132 132 132 132
132 132 132 132 51 67 132 132 132 132 132 132 132 132 132 132 132 132
132 132 132 132 132 132 89 132 132 132 132 132 132 132 132 132 132 132
132 132 132 132 141 67 78 132 132 132 132 132 132 132 132 132 132 132
132 132 132 132 132 132 161 132 132 132 132 132 132 132 132 132 132 132
132 132 132 132 132 114 161 132 132 132 132 132 132 132 132 132 132 132
64 4 51 132 132 4 161 31 132 132 132 132 132 132 132 132 132 132
67 67 67 132 132 132 161 132 132 132 132 132 132 132 132 132 132 132
78 77 90 132 132 132 67 86 132 132 132 132 132 132 132 132 132 132
51 67 79 132 132 132 132 132 132 132 132 132 132 132 132 132 132 132
