18 18
132 132 132 132 132 132 132 4 67 77 132 132 132 132 132 132 132 132
132 132 132 132 132 132 132 132 132 132 132 132 132 132 132 132 132 132
132 86 86 86 132 132 132 132 132 132 132 132 132 132 132 132 132 132
132 132 86 135 132 132 132 132 132 132 132 132 132 86 86 89 132 132
132 132 150 86 135 86 132 132 132 132 132 132 86 86 135 135 132 132
132 132 132 150 86 135 135 135 135 86 86 86 86 135 135 132 132 132
132 132 132 132 132 25 135 135 135 25 25 86 86 86 132 132 132 132
132 132 132 132 132 135 135 135 25 86 25 86 86 132 132 132 132 132
77 67 78 132 135 135 132 132 86 86 135 4 132 86 132 132 132 132
132 132 132 132 135 25 132 132 86 86 135 67 132 86 132 132 132 132
44 51 132 132 25 25 135 25 86 86 86 86 135 86 132 132 132 132
132 132 132 132 25 25 25 25 86 86 86 86 86 135 132 132 132 132
132 132 132 132 148 25 25 86 132 86 86 86 148 135 86 132 132 132
132 132 132 132 148 135 25 132 55 132 86 86 148 135 86 132 132 132
132 132 132 132 135 135 25 132 148 132 86 86 148 135 135 132 132 132
132 132 132 132 86 135 25 25 132 25 86 86 86 86 135 25 132 132
132 132 132 25 86 135 25 25 25 25 25 25 86 86 89 25 132 132
132 132 25 25 86 135 135 135 86 86 86 86 86 89 89 25 25 132
