8 8
132 132 132 132 132 132 132 132
148 132 132 135 132 132 132 132
132 135 132 132 25 132 44 154
154 132 132 132 132 64 67 78
141 132 132 67 77 67 78 132
132 132 132 132 135 86 154 132
132 132 132 132 154 25 132 132
114 132 132 154 150 83 132 132
