8 8
132 132 132 132 132 132 135 132
132 132 132 132 132 132 132 132
132 132 132 132 132 132 132 132
132 132 132 132 132 132 132 132
132 132 4 67 77 132 132 132
77 79 132 132 132 132 132 132
132 132 132 67 88 132 132 132
132 132 25 67 86 132 132 132
