8 8
132 132 132 132 132 132 135 132
132 132 132 132 132 132 132 132
132 132 132 132 132 132 132 132
132 132 132 132 132 132 132 132
132 44 67 77 132 132 132 132
132 132 132 132 4 132 25 132
114 132 132 132 132 132 67 132
132 132 132 132 132 132 86 132
