8 8
132 4 132 132 132 25 132 132
132 67 132 132 132 67 132 132
132 77 114 132 132 86 148 132
132 132 132 132 132 132 132 132
132 132 132 132 161 132 132 132
132 51 132 132 132 132 132 132
132 132 132 132 132 132 132 132
132 132 132 132 132 132 132 132
