10 10
132 132 132 132 132 132 132 132 132 132
150 150 150 150 150 150 150 150 132 132
132 132 132 132 132 161 132 132 132 132
132 132 132 132 132 132 132 132 132 132
132 132 114 132 132 161 132 132 132 132
132 132 132 132 132 132 132 132 132 132
132 132 132 132 132 132 132 132 132 132
64 67 86 132 132 132 67 83 132 132
132 132 132 132 132 132 132 132 132 132
4 67 77 132 132 132 132 132 132 132
