10 10
25 67 86 132 132 132 132 38 67 132
132 132 132 132 132 148 132 135 132 132
132 132 132 132 148 132 132 132 132 132
132 148 132 132 132 132 132 132 132 132
132 132 132 132 132 132 132 132 148 132
132 148 132 132 132 132 132 132 132 132
132 132 132 132 132 132 132 132 148 132
132 148 132 132 132 132 132 132 132 132
132 132 132 132 114 132 132 132 132 132
38 67 83 132 132 132 132 4 67 77
