8 8
4 67 77 132 132 132 132 25
67 132 132 132 132 132 132 67
90 150 150 150 40 132 135 86
132 132 161 150 67 132 132 132
132 132 132 150 89 132 132 132
132 132 132 150 150 150 150 150
132 114 161 132 132 132 132 132
132 132 132 132 51 67 79 132
