9 16
4 67 77 132 132 132 132 132 132
132 132 132 132 132 114 161 148 132
132 51 132 132 132 132 132 132 132
132 132 132 132 132 132 132 132 132
132 132 132 132 132 132 132 132 132
132 67 132 132 132 132 132 132 132
132 79 132 132 132 132 132 132 132
132 132 132 132 132 132 132 132 132
132 38 132 132 132 132 132 132 132
132 132 132 132 132 132 132 132 132
132 132 132 132 132 132 132 132 132
132 132 132 132 132 132 132 132 132
132 132 132 132 132 132 132 132 132
132 132 132 132 132 132 132 135 132
64 67 78 132 132 132 132 132 132
132 67 88 132 132 132 25 67 86
