8 8
148 132 132 132 132 114 132 132
132 132 132 132 132 132 132 132
165 4 67 77 86 132 132 132
132 135 51 132 132 132 132 132
132 132 132 132 132 114 132 132
132 161 132 132 135 132 132 132
132 165 132 114 165 132 132 148
132 132 165 132 132 132 132 132
