8 8
132 132 132 67 77 132 132 132
132 132 132 161 132 132 132 132
77 132 132 132 4 67 67 132
132 132 132 132 132 132 86 67
165 77 132 86 132 132 132 77
132 132 132 132 132 132 132 132
132 132 51 67 132 132 25 67
132 132 132 132 132 55 67 132
