9 16
161 132 90 55 148 132 135 44 161
132 25 132 78 64 132 44 88 141
25 132 88 132 86 132 78 141 4
141 79 64 132 132 79 141 77 150
132 64 132 79 38 150 25 132 67
132 132 67 90 86 132 165 51 77
154 25 86 89 154 44 114 132 148
64 132 114 141 55 132 38 67 38
148 132 90 132 64 132 132 77 67
88 4 31 132 132 86 132 40 77
132 90 132 132 55 132 90 90 154
132 90 4 161 79 38 148 114 148
132 150 83 51 51 132 78 161 86
40 25 135 135 44 132 132 132 154
132 31 89 132 161 132 67 132 161
44 64 44 83 51 132 132 86 132
