13 13
132 150 132 132 132 40 67 78 132 132 132 150 132
132 150 132 132 132 132 132 132 132 132 132 150 132
132 132 132 132 132 132 132 132 132 132 132 132 132
132 132 132 132 132 132 132 132 132 132 132 132 132
132 132 150 132 132 132 132 132 132 132 150 132 132
132 132 150 132 132 132 132 132 132 132 150 132 132
86 132 132 132 132 132 67 88 132 132 132 132 86
132 132 150 132 132 132 132 132 132 132 150 132 132
132 132 150 132 132 132 132 132 132 132 150 132 132
132 132 132 132 132 132 132 132 132 132 132 132 132
132 132 132 132 132 132 132 132 132 132 132 132 132
132 150 132 132 132 132 132 132 132 132 132 150 132
132 150 132 132 132 40 67 77 132 132 132 150 132
