8 8
132 148 55 25 161 132 132 132
154 114 51 67 55 114 114 132
132 132 132 86 67 165 148 4
161 132 132 132 77 165 132 89
114 165 165 132 132 132 141 132
25 51 132 132 132 141 141 132
55 67 132 132 132 132 132 132
64 78 51 67 67 132 132 135
