8 8
132 132 132 132 132 132 132 132
132 132 132 132 44 67 77 132
132 132 132 132 132 132 132 132
132 132 132 154 132 132 132 132
25 132 154 132 154 132 132 132
67 132 132 154 132 132 132 132
86 132 132 132 132 132 132 132
132 132 132 132 135 132 132 132
