10 10
38 132 132 132 132 148 132 38 67 132
67 132 132 132 132 148 148 135 132 132
83 132 132 132 4 67 77 132 132 132
165 132 148 132 132 132 132 132 132 132
132 132 132 132 132 132 132 51 132 132
132 132 132 132 132 132 132 64 67 78
132 132 132 132 132 132 132 132 132 132
132 132 132 132 132 132 161 132 132 148
132 132 132 132 132 132 132 132 132 132
132 132 148 132 132 132 25 67 86 132
