8 8
132 132 132 67 77 132 132 132
132 132 132 161 132 67 132 132
132 132 132 132 132 132 132 132
132 165 132 132 132 148 77 132
25 67 77 132 44 83 135 132
132 132 25 132 154 132 132 132
86 51 77 79 38 132 132 132
132 132 154 132 132 132 132 132
