10 5
154 132 132 132 132 132 132 44 67 77
132 132 132 135 132 132 132 132 132 25
132 51 132 132 132 132 132 114 132 67
4 67 77 132 132 132 132 132 132 86
132 132 132 55 132 55 67 132 132 132
