8 8
64 67 78 132 132 51 67 79
132 132 132 132 132 51 67 86
132 132 51 132 132 132 132 132
4 67 4 67 77 132 132 132
132 132 132 132 132 132 132 161
132 132 132 132 132 132 132 132
132 132 132 51 132 132 132 132
114 4 67 132 132 51 67 90
