8 8
4 67 4 132 132 132 132 135
67 132 132 132 132 132 132 132
77 132 132 132 132 132 132 132
132 132 132 132 132 132 132 132
132 132 132 132 132 132 132 132
132 132 132 132 132 132 132 25
132 132 132 132 132 132 132 67
114 132 132 132 132 132 132 86
