8 14
44 67 44 132 132 132 132 4
132 132 132 132 132 132 132 67
44 67 132 132 132 132 132 77
132 132 25 132 132 132 132 132
132 132 132 132 132 132 132 132
132 132 132 132 132 132 132 132
132 132 132 132 132 132 132 132
114 154 132 132 132 132 83 25
132 132 132 132 132 132 132 67
132 132 132 132 132 132 132 86
132 132 132 132 132 132 132 132
132 154 132 132 132 132 64 132
132 132 132 132 132 132 67 132
135 132 132 132 132 132 78 132
