8 14
44 67 44 132 132 132 132 4
132 67 44 67 83 132 132 132
132 132 132 132 132 132 132 132
132 132 132 132 132 132 132 132
132 154 132 132 132 132 132 25
132 67 132 132 132 132 132 132
132 132 132 132 132 154 132 132
132 132 132 132 67 132 135 132
