8 8
132 38 67 132 132 4 67 77
132 135 132 132 132 132 132 132
77 132 132 132 132 132 132 86
132 132 67 132 64 132 132 132
132 132 132 132 132 132 148 132
132 132 132 132 161 161 132 132
132 132 132 132 132 132 132 132
132 132 132 132 114 38 67 83
