8 8
150 132 132 132 132 132 132 132
132 132 132 114 132 132 132 132
40 67 4 132 132 132 132 132
132 132 67 132 132 132 132 132
132 132 77 25 132 132 132 132
132 114 132 114 4 67 4 161
132 132 132 132 132 132 132 132
132 135 132 132 132 132 67 86
