8 8
114 132 132 132 132 44 132 154
132 132 132 132 132 67 132 132
132 132 132 132 132 86 132 132
132 132 132 132 132 132 132 132
132 132 132 132 132 132 132 132
132 132 132 132 132 4 64 132
132 132 132 132 132 67 67 132
132 132 132 132 132 77 78 132
