8 8
114 25 67 86 77 132 132 132
132 132 132 132 132 67 132 67
132 132 4 67 77 141 132 132
132 51 25 67 86 132 132 161
31 67 77 132 132 132 132 132
132 132 132 132 132 132 64 25
132 132 132 132 132 132 25 67
132 132 132 132 132 135 132 132
