8 8
64 67 78 132 132 132 165 132
132 67 132 132 25 132 132 132
25 132 132 132 67 132 132 132
132 132 132 132 86 132 132 132
132 132 161 132 132 132 132 132
132 132 132 132 51 132 114 132
55 67 132 132 4 67 77 132
132 67 25 132 132 132 132 161
