8 8
132 132 132 132 132 132 132 132
64 64 132 132 64 67 78 132
67 67 114 132 4 67 77 132
90 64 132 132 132 132 132 132
132 132 132 132 132 132 132 132
25 40 132 132 132 132 132 132
67 67 132 132 132 132 150 150
86 89 132 132 132 132 150 135
