14 11
38 67 83 132 132 132 132 132 132 132 132 132 132 132
67 132 132 132 132 86 132 132 132 132 132 132 132 132
132 132 132 132 148 132 132 132 64 132 132 132 132 132
132 132 150 132 132 132 132 132 67 132 132 132 132 132
132 132 150 132 132 148 132 83 78 64 132 132 132 132
132 132 150 132 132 132 132 132 132 132 132 132 132 132
150 150 150 150 150 150 150 150 150 132 132 132 132 132
132 132 132 132 132 132 150 150 132 132 132 132 132 132
132 132 132 132 132 132 132 132 132 132 132 132 132 132
114 132 132 132 132 132 132 132 132 132 132 132 132 132
40 67 132 132 132 132 132 132 132 132 132 4 67 77
