8 8
132 132 132 38 132 86 132 132
132 135 132 148 132 132 132 132
148 148 148 148 132 132 132 132
132 132 132 148 132 148 148 148
132 132 132 132 132 132 132 132
132 67 88 132 132 132 114 132
132 132 132 132 132 4 67 77
38 67 132 132 132 25 67 86
