8 8
132 132 4 132 132 150 150 150
132 132 67 132 132 150 150 150
132 132 77 132 132 150 150 150
132 132 132 132 132 150 150 150
132 132 132 132 132 150 150 150
64 67 132 132 132 132 132 132
132 132 78 132 25 67 86 132
165 132 132 132 132 132 132 135
