8 8
132 67 88 132 150 132 135 132
132 141 141 132 150 132 150 132
132 51 132 132 132 132 150 150
132 114 132 132 132 132 132 150
132 132 132 141 132 132 132 141
132 132 161 132 132 132 132 79
4 67 77 132 67 132 132 132
25 67 86 141 132 40 67 78
