8 8
132 132 132 132 132 114 132 165
25 4 165 132 132 132 132 165
135 67 86 132 132 132 132 165
132 77 132 132 161 161 161 161
132 132 132 161 132 132 132 132
132 132 132 161 132 51 25 132
132 132 132 161 132 67 67 132
55 67 132 161 132 79 132 132
