8 8
114 64 67 77 132 132 25 161
132 132 132 132 132 132 132 132
132 132 132 132 132 132 132 55
132 165 132 132 132 165 132 67
132 132 132 132 132 132 132 132
4 132 86 165 67 132 132 55
67 132 132 132 132 132 132 132
77 132 132 132 132 132 51 135
