10 11
132 132 132 132 132 132 132 132 132 132
161 132 132 132 132 135 132 132 132 132
132 132 132 132 165 165 165 165 132 51
132 132 132 132 132 114 25 4 67 132
135 132 132 132 132 67 31 132 132 132
132 132 132 132 132 132 161 165 165 165
165 165 165 165 132 132 132 132 132 132
132 132 25 165 165 132 132 132 51 132
132 67 132 132 132 132 4 67 77 64
86 132 55 67 132 132 132 132 67 132
