8 8
25 67 86 132 132 132 132 132
132 132 51 67 79 31 132 67
132 132 132 132 132 132 132 88
31 132 141 132 114 132 31 132
132 132 132 132 31 132 132 132
4 132 132 132 132 132 132 132
67 132 31 132 31 132 132 31
77 132 132 132 132 132 132 135
