8 8
132 4 67 132 132 132 132 132
165 132 132 55 132 132 132 135
132 132 67 132 132 132 132 132
132 132 132 55 25 132 132 67
67 132 132 132 4 132 132 132
86 114 132 132 86 132 132 132
132 132 132 132 132 132 132 165
132 64 67 77 132 165 132 132
