8 8
132 132 132 132 132 132 132 132
4 67 77 132 132 132 132 132
55 67 78 132 132 132 132 132
38 67 86 132 114 132 132 132
132 67 78 132 132 132 132 132
25 67 78 132 132 154 132 154
132 132 132 132 132 154 165 154
44 67 78 132 132 154 148 135
