9 9
165 132 132 132 135 132 132 132 165
132 148 132 132 132 132 132 148 132
132 132 148 132 132 132 148 132 132
132 132 132 148 132 148 132 132 132
132 132 132 132 148 132 132 132 132
132 132 132 132 132 132 132 132 132
132 132 132 132 132 132 132 132 132
38 67 83 132 132 132 38 67 132
4 67 77 132 132 132 25 67 86
