8 8
132 4 67 132 165 25 67 86
55 67 132 77 165 132 132 132
132 132 132 135 165 132 132 132
165 165 165 165 165 132 132 132
132 132 132 132 132 132 132 132
132 132 132 132 132 67 83 132
132 4 67 77 132 132 114 132
132 132 132 132 132 132 132 132
