8 8
132 135 132 132 132 132 132 132
132 132 132 132 132 132 132 86
148 148 148 148 132 148 148 148
132 132 132 132 132 132 132 132
38 67 132 148 132 148 132 132
132 132 132 148 132 148 148 148
4 67 77 148 132 132 114 132
25 67 86 132 132 132 132 132
