8 8
132 132 132 132 132 132 132 132
132 132 132 25 67 86 132 132
132 132 132 132 132 132 132 132
132 132 132 132 132 132 132 154
4 132 132 132 132 132 141 132
67 132 132 132 132 132 132 132
77 132 132 132 132 132 132 132
132 132 148 132 135 114 132 55
