8 8
4 67 77 132 132 132 132 135
25 67 86 31 132 132 132 132
51 67 79 132 132 132 132 132
132 67 88 132 132 132 132 132
132 31 132 132 132 132 132 132
132 132 161 132 132 161 161 132
132 132 161 161 161 161 161 161
114 132 132 161 161 132 132 132
