18 12
4 132 55 67 132 132 132 67 78 132 51 67 79 132 4 67 77 132
67 132 25 67 86 132 132 67 78 132 44 67 83 132 132 132 132 132
132 55 154 132 132 132 132 132 132 132 132 132 132 132 132 132 132 132
51 132 132 132 132 132 132 132 132 132 132 132 132 132 132 132 132 132
67 132 132 132 132 132 132 132 132 132 132 132 132 132 132 132 132 132
132 25 132 132 132 132 132 132 132 132 132 132 132 132 132 132 132 132
132 132 132 132 132 132 132 132 132 132 132 132 132 132 132 132 132 132
132 132 132 132 132 132 132 132 132 132 132 132 132 132 132 132 132 132
132 132 132 132 132 132 132 132 132 132 132 132 132 132 132 132 132 132
132 132 132 132 132 132 132 132 132 132 132 161 132 132 132 132 132 132
132 132 132 132 132 132 132 132 132 132 132 132 114 132 132 132 132 132
132 132 132 132 132 132 132 132 132 132 132 132 132 141 141 141 141 141
