8 15
132 132 132 132 132 132 132 132
132 132 132 132 132 132 132 132
132 4 132 132 132 148 132 132
67 132 132 132 132 132 132 132
132 132 132 154 132 132 132 132
132 114 132 132 132 132 132 132
132 132 132 132 132 132 132 132
132 132 132 132 132 86 132 132
132 132 132 38 132 132 132 132
132 132 132 132 67 132 132 132
132 132 83 132 132 132 132 132
132 132 132 132 132 132 132 132
132 132 132 132 132 132 132 44
132 132 132 132 132 132 132 67
4 67 77 132 132 64 67 132
