8 8
25 67 86 132 132 132 132 132
132 132 51 161 67 141 132 67
132 132 132 132 132 132 132 88
141 132 132 132 132 132 141 132
132 132 132 132 141 132 132 132
4 132 132 132 132 132 132 132
67 132 141 132 141 161 132 141
77 132 132 132 132 132 132 135
