8 15
132 132 132 132 4 67 77 114
132 132 132 132 114 132 132 132
132 132 132 132 132 132 132 25
132 132 132 67 132 132 132 67
132 132 132 132 132 132 67 77
132 132 132 132 132 132 132 132
132 114 132 132 132 135 132 132
132 132 132 132 132 132 132 132
132 67 132 132 51 161 132 132
132 135 51 135 67 77 132 148
132 132 135 86 78 132 132 132
132 114 132 67 79 132 132 25
132 132 135 132 132 132 132 67
132 132 132 132 132 132 132 132
38 67 86 132 132 132 132 132
