8 15
132 132 132 132 4 67 77 132
132 132 132 132 132 132 132 132
132 132 132 132 132 132 132 132
132 132 132 132 132 132 132 132
132 132 132 132 132 67 132 132
135 67 77 114 148 132 132 135
132 86 79 132 132 25 132 132
132 132 132 132 132 132 132 38
