9 9
132 40 132 40 4 40 132 40 132
132 67 132 67 67 67 132 67 132
132 89 132 89 77 89 132 89 132
132 132 132 67 86 67 132 132 132
40 67 89 132 114 132 132 132 132
132 132 132 132 132 132 132 132 132
40 67 89 132 64 132 40 67 89
132 132 132 132 67 132 132 132 132
40 67 132 132 78 132 132 67 40
