13 13
4 67 77 132 132 64 67 78 132 132 25 67 86
38 67 132 132 132 132 132 132 132 132 132 132 148
67 132 132 132 132 132 132 132 132 132 148 132 132
83 132 67 132 132 132 132 132 132 132 132 132 148
135 132 132 132 132 132 132 132 132 132 148 132 132
132 132 132 132 132 132 132 148 132 132 132 132 132
132 132 132 132 132 148 132 132 132 132 132 132 132
132 132 132 132 132 132 132 148 132 132 132 132 132
132 132 132 132 132 148 132 132 132 132 132 132 132
148 132 132 132 132 132 132 132 148 132 132 132 148
132 132 148 132 132 132 132 132 132 132 148 132 132
148 132 132 132 132 132 132 132 132 132 132 148 132
132 132 132 132 132 132 132 132 132 132 132 132 132
