15 13
25 67 86 132 132 135 132 132 132 31 132 132 132 161 132
132 31 132 132 31 132 132 132 114 132 31 132 31 132 132
132 132 161 132 132 132 132 132 132 132 132 132 132 132 132
132 132 132 31 132 132 132 31 132 132 132 132 31 132 132
132 132 132 132 132 132 132 132 132 132 132 132 132 132 132
132 31 132 132 132 132 132 132 132 132 132 31 161 132 132
132 132 132 132 132 132 132 132 132 132 132 132 132 132 132
132 31 132 132 132 31 132 132 132 132 132 132 114 31 132
132 132 114 132 132 132 132 132 132 31 132 132 132 132 132
132 132 132 132 132 132 132 132 132 132 132 132 31 161 132
148 132 132 132 31 132 132 132 132 132 31 132 132 132 132
132 132 132 132 132 132 132 132 132 132 132 132 4 67 132
51 67 78 132 64 67 78 132 38 67 77 132 4 67 83
