8 8
132 132 132 165 132 44 67 77
154 132 132 165 132 132 132 132
132 132 165 165 165 135 165 165
132 132 165 132 132 165 132 132
25 132 132 165 132 132 165 132
67 132 132 132 132 132 165 132
86 132 132 55 67 132 132 132
132 132 132 132 132 132 132 132
