9 13
4 67 90 40 67 89 25 67 86
67 132 132 132 132 132 132 132 64
77 132 132 132 114 132 132 132 67
132 132 132 132 132 132 132 132 78
132 132 141 132 132 132 132 132 141
31 132 67 132 31 132 132 132 67
132 132 132 79 132 132 132 132 90
132 150 150 150 150 150 150 150 150
132 150 150 150 150 150 150 150 150
132 132 132 132 132 150 132 132 132
132 44 67 132 154 150 132 135 132
132 67 132 132 132 150 132 132 132
132 132 77 132 150 150 150 150 150
