8 8
132 132 132 132 132 40 67 132
132 150 150 38 67 132 132 25
132 64 161 114 132 132 132 67
132 132 132 132 132 132 132 86
132 132 132 132 132 132 132 132
132 51 67 132 132 132 132 132
132 132 132 132 132 132 132 132
132 67 25 132 132 4 67 77
