8 8
132 132 132 132 132 44 132 4
132 132 132 132 132 67 132 67
132 132 132 132 132 90 132 77
132 25 132 132 132 165 132 132
55 67 132 165 165 165 132 132
132 86 132 132 132 132 132 132
132 132 132 132 132 132 132 132
132 132 132 132 135 132 132 148
