12 12
150 132 114 25 148 132 132 132 150 132 132 132
150 132 4 67 77 132 132 132 150 132 132 132
150 132 148 132 77 132 132 132 132 150 132 132
150 150 132 132 132 51 132 132 161 150 77 132
132 67 150 132 132 132 132 132 132 150 132 132
132 132 150 150 38 150 132 150 150 150 132 132
132 148 132 132 67 132 132 132 132 132 132 132
132 132 132 132 89 132 135 132 132 132 132 132
132 132 77 132 132 132 132 132 132 132 132 132
132 132 25 67 132 90 132 132 38 67 77 132
132 132 132 86 132 132 132 132 132 132 132 132
132 132 132 132 132 132 132 132 132 132 132 132
