18 11
132 40 141 141 150 150 132 132 132 132 132 132 132 132 132 4 132 132
132 67 141 141 150 150 132 132 132 132 132 132 132 132 132 67 67 132
132 89 141 141 150 150 132 132 132 132 132 132 132 132 132 90 88 132
132 132 141 141 150 150 132 132 132 132 132 132 132 132 132 132 132 132
132 132 90 141 150 150 132 132 132 132 132 132 132 132 132 154 132 132
132 132 141 141 150 150 132 132 132 132 132 132 132 132 132 44 132 132
114 132 77 141 150 150 132 132 132 132 132 132 132 132 132 67 132 132
150 150 150 150 150 150 132 132 132 132 132 132 132 132 132 86 132 132
150 150 150 150 150 150 132 132 132 132 132 132 132 132 132 132 132 132
132 132 132 132 132 132 132 132 132 132 132 132 132 132 132 132 132 132
132 132 132 132 132 132 132 132 132 132 132 132 132 132 132 4 67 77
