8 8
132 77 132 132 132 132 132 132
55 132 132 114 132 132 132 132
132 132 4 132 132 132 132 132
132 132 67 132 132 132 132 132
64 67 132 132 132 132 132 132
132 25 67 77 165 165 132 132
132 132 132 132 4 67 77 86
132 135 132 132 132 132 132 86
