8 8
114 132 132 132 132 25 67 86
150 132 132 64 67 78 132 132
150 150 132 150 150 150 150 150
132 132 132 132 132 44 132 132
132 132 132 132 132 132 67 77
154 132 132 67 132 40 67 89
135 132 132 88 132 132 132 132
132 132 132 132 132 4 67 77
