9 8
4 67 77 31 31 114 132 132 132
132 132 132 132 132 132 132 141 132
132 132 132 132 132 132 132 67 132
25 67 86 132 132 132 132 83 132
132 132 132 132 132 132 132 132 132
132 132 132 132 132 132 132 132 132
132 132 132 132 135 132 132 132 132
64 67 78 132 148 132 132 67 132
