8 8
132 132 132 132 132 132 132 132
132 132 132 132 132 132 132 132
132 132 25 67 77 132 132 132
132 132 132 132 132 132 132 132
132 132 132 132 86 67 31 132
135 135 135 132 132 132 132 132
132 132 135 132 132 132 132 132
141 132 135 132 132 132 132 132
