8 8
132 132 132 132 132 132 132 132
132 132 132 132 132 132 132 132
132 132 132 132 132 132 132 132
25 132 132 132 132 132 132 132
67 132 4 132 135 132 132 132
86 132 67 132 132 132 132 132
132 132 77 132 132 132 132 132
132 132 132 132 132 132 132 132
