8 8
132 132 132 132 132 132 132 132
132 132 132 132 132 132 132 132
132 132 135 132 132 132 132 132
132 132 132 132 132 132 132 132
132 132 132 38 67 86 132 132
132 161 132 132 132 132 4 132
132 132 132 132 132 132 67 132
132 132 132 114 132 132 77 148
