8 8
4 67 132 31 132 4 67 77
135 132 132 132 132 67 77 132
114 132 132 132 132 161 132 67
67 132 132 132 132 132 132 132
86 132 132 51 161 161 132 79
132 132 132 132 161 132 132 150
132 83 132 132 132 141 161 132
38 77 132 148 132 132 132 161
