8 8
4 67 77 132 132 25 67 86
67 132 132 132 132 132 132 132
90 132 132 132 132 132 132 132
132 132 161 114 132 90 132 132
132 132 132 132 132 132 132 132
132 132 51 132 132 79 132 132
132 132 67 132 132 132 132 154
44 67 89 132 132 132 154 135
