8 8
114 132 132 132 132 132 132 4
132 132 67 132 51 132 132 67
132 51 132 132 132 79 132 77
132 132 132 132 132 132 132 132
132 88 132 161 161 161 132 132
132 132 132 132 132 132 132 132
132 132 132 132 132 132 67 88
135 132 132 132 132 25 67 86
