8 8
132 132 132 132 132 132 132 132
132 114 132 132 132 132 132 132
132 132 4 132 132 132 132 132
132 132 67 132 132 132 132 132
132 132 77 132 132 132 132 132
132 132 86 132 132 132 132 132
132 55 165 132 132 132 132 132
132 132 132 132 132 132 132 132
