8 8
114 132 132 132 132 132 132 132
132 132 132 132 132 132 132 132
132 132 132 135 132 132 132 132
4 132 132 132 132 132 132 132
67 132 132 132 132 132 132 132
77 132 132 132 132 132 132 132
150 132 132 132 132 132 132 132
135 135 132 150 25 67 86 132
