8 8
132 132 132 132 4 67 77 132
132 132 132 132 25 67 86 132
148 132 132 132 132 132 132 132
132 132 132 132 132 67 132 132
132 132 132 132 135 51 132 132
132 132 132 132 132 132 132 132
132 132 132 132 132 132 132 132
132 132 132 132 161 132 132 132
