8 8
55 67 86 132 132 132 132 132
132 132 132 132 132 132 132 135
132 132 132 132 132 132 132 86
132 132 132 132 132 132 132 132
132 132 132 132 132 132 132 132
25 67 132 132 132 51 67 77
132 132 132 132 132 132 132 132
132 132 132 132 132 132 165 132
